XXXXXXXXX
XO  O   X
X BBOBB X
X   B   X
XXXXOXXXX
XXXX XXXX
X   O   X
X  B8B  X
XO  O   X
XXXXXXXXX